0:0 0:0 0:0 0:0 0:0 0:0 0:0 0:0 0:0 0:0 0:0 0:0 0:0 0:0 0:0 0:0
0:0 0:0 0:0 0:0 0:0 0:0 0:0 0:0 0:0 0:0 o:1 0:0 0:0 0:0 m:0 0:0
0:0 0:0 0:0 0:0 0:0 0:0 0:0 0:0 0:0 0:0 0:0 0:0 0:0 0:0 0:0 0:0
0:0 0:0 0:0 0:0 0:0 0:0 0:0 0:0 0:0 0:0 0:0 0:0 m:0 0:0 o:0 0:0
0:0 0:0 0:0 0:0 0:0 0:0 0:0 0:0 0:0 0:0 0:0 0:0 0:0 0:0 0:0 0:0
0:0 0:0 0:0 0:0 0:0 0:0 0:0 0:0 0:0 0:0 0:0 o:1 0:0 0:0 0:0 0:0
0:0 0:0 0:0 0:0 0:0 0:0 0:0 0:0 0:0 m:0 0:0 0:0 0:0 0:0 0:0 0:0
0:0 0:0 0:0 0:0 m:0 0:0 0:0 0:0 0:0 0:0 0:0 0:0 0:0 0:0 m:0 0:0
0:0 o:3 0:0 0:0 0:0 0:0 0:0 0:0 0:0 0:0 0:0 m:0 0:0 0:0 0:0 0:0
0:0 o:0 m:0 0:0 0:0 0:0 0:0 0:0 0:0 o:1 0:0 0:0 0:0 0:0 0:0 0:0
0:0 0:0 0:0 0:0 0:0 0:0 0:0 0:0 0:0 o:2 0:0 0:0 m:0 o:0 o:2 0:0
0:0 0:0 0:0 0:0 0:0 0:0 0:0 0:0 0:0 0:0 0:0 0:0 0:0 0:0 0:0 0:0