1 1 1 1 1 1 1 1 1 1 1 1 1 1 1 1
1 5 5 5 5 5 5 5 5 5 5 5 5 5 5 1
1 5 5 5 5 5 5 5 5 5 5 5 5 5 5 1
1 2 2 2 5 1 1 1 1 1 1 1 1 5 1 1
1 2 2 2 5 5 1 1 1 1 1 1 5 5 5 1
1 2 2 2 2 5 5 1 5 5 3 5 5 5 5 1
1 2 2 2 2 5 5 1 5 5 5 5 5 5 5 1
1 2 2 2 2 5 5 1 1 5 1 1 1 5 1 1
1 5 5 5 5 5 5 1 5 5 5 1 5 5 5 1
1 5 5 5 5 5 1 1 5 5 5 1 5 5 5 1
1 5 5 5 5 5 3 1 5 5 5 1 5 5 5 1
1 1 1 1 1 1 1 1 1 7 1 1 1 1 1 1