1 1 4 4 4 1 1 1 1 4 4 2 2 2 2 2
1 5 5 5 5 5 5 5 5 5 5 4 0 0 0 2
1 5 5 3 3 3 5 5 5 3 3 4 0 0 0 2
1 5 5 5 3 5 5 5 5 5 5 3 5 5 5 2
1 0 0 4 3 4 0 0 0 0 0 0 0 0 0 2
2 2 2 2 3 2 2 2 2 2 2 2 2 2 2 2
2 2 2 2 3 2 2 2 2 2 2 2 2 2 2 2
4 4 4 4 5 4 4 4 5 4 4 4 4 4 4 4
4 4 4 4 5 4 4 4 5 4 4 4 4 4 4 4
4 5 5 1 5 5 5 5 5 5 5 5 5 5 5 4
4 5 5 5 5 5 5 5 1 5 1 5 1 5 5 4
4 4 4 4 4 4 4 4 4 7 4 4 4 4 4 4