4 4 4 4 4 4 4 4 4 4 4 4 4 4 4 4
4 5 5 5 5 5 5 5 5 5 5 3 3 3 3 4
4 5 5 5 5 5 5 5 5 5 1 3 1 3 3 4
4 4 4 4 0 4 4 4 4 0 4 3 3 1 3 4
4 0 0 0 0 4 4 4 4 0 4 3 3 3 3 4
4 2 2 2 0 4 4 4 4 0 4 3 1 1 1 4
4 2 2 2 0 4 4 4 4 0 4 5 5 5 5 4
4 2 2 2 0 4 4 4 4 0 4 5 5 1 5 4
4 0 0 0 0 4 4 4 4 0 4 5 5 1 5 4
4 5 5 5 5 4 4 4 1 0 1 5 5 1 5 4
4 5 5 5 4 4 4 4 1 5 1 5 5 5 5 4
4 4 4 4 4 4 4 4 1 7 1 4 4 4 4 4