0 0 0 0 0 0 0 0 0 0 0 0 0 0 0 0
0 11 11 11 11 11 11 11 11 11 11 11 11 11 11 0
15 11 11 11 11 11 11 11 11 11 11 11 11 11 11 0
0 18 18 18 11 0 0 0 0 0 0 0 15 11 15 0
0 18 18 18 11 11 0 0 15 15 15 15 11 11 11 0
0 18 18 18 18 11 11 0 11 11 9 11 11 11 11 0
15 18 18 18 18 11 11 0 11 11 11 11 11 11 11 0
0 18 18 18 18 11 11 0 15 11 0 15 0 11 0 0
0 11 11 11 11 11 11 0 11 11 11 0 11 11 11 0
0 11 11 11 11 11 15 0 11 11 11 0 11 11 11 0
0 11 11 11 11 11 9 0 11 11 11 0 11 11 11 0
0 0 15 15 15 0 0 0 0 3 0 0 0 15 0 15