14 14 14 14 14 14 14 14 14 14 14 14 14 14 14 14
14 6 6 6 6 6 6 6 6 6 6 19 19 19 19 14
14 6 6 6 6 6 6 6 6 6 1 19 1 19 19 14
14 14 14 14 19 14 14 14 14 19 14 19 19 1 19 14
14 19 19 19 19 14 14 14 14 19 14 19 19 19 19 14
14 18 18 18 19 14 14 14 14 19 14 19 1 1 1 14
14 18 18 18 19 14 14 14 14 19 14 6 6 6 6 14
14 18 18 18 19 14 14 14 14 19 14 6 6 1 6 14
14 19 19 19 19 14 14 14 14 19 14 6 6 1 6 14
14 6 6 6 6 14 14 14 1 19 1 6 6 1 6 14
14 6 6 6 14 14 14 14 1 6 1 6 6 6 6 14
14 14 14 14 14 14 14 14 1 4 1 14 14 14 14 14