2 2 17 17 17 2 2 2 2 17 21 2 2 2 2 20
2 13 13 13 13 13 13 13 13 13 13 21 22 22 22 20
2 13 13 9 9 9 13 13 13 9 9 21 22 22 22 20
2 13 13 13 9 13 13 13 13 13 13 9 13 13 13 20
2 22 22 17 9 21 22 22 22 22 22 22 22 22 22 20
20 20 20 20 9 20 20 20 20 20 20 20 20 20 20 20
20 20 20 20 9 20 20 20 20 20 20 20 20 20 20 20
16 16 16 16 8 16 16 16 8 16 16 16 16 16 16 16
16 16 16 16 8 16 16 16 8 16 16 16 16 16 16 16
16 8 8 1 8 8 8 8 8 8 8 8 8 8 8 16
16 8 8 8 8 8 8 8 1 8 1 8 1 8 8 16
16 16 16 16 16 16 16 16 16 5 16 16 16 16 16 16